flowchans - flowcharts
MANCH ESTER - MANCHESTER
Descrigfion - Description
Iines - lines
thy - the
tho - the
we'' - well
inpux - input
ptinter - printer
hava - have
vatiable - variable
Rayon - layout
DiCTIOMARY - DICTIONARY
documentatmn - documentation
jndex - index
primifives - primitives
pomter - pointer
FILEDUTPUT - FILEOUTPUT
INITSEO - INITSEQ
INVUT - INPUT
TABUST - TABLIST
YITLE - TITLE
FAG EMSG - PAGEMSG
OLDJNSTREAM - OLD.INSTREAM
BUFFPTH - BUFFPTR
HDCHAH - HDCHAR
USEEFORM - USER.FORM
DESPLNS - DISPLNS
PD?! 1- PDP1
LSBOZXS - LIB02X3
MUB - MU6
eTLSEG - *TLSEG
eTLLOAD - *TLLOAD
INFOHM - INFORM
ENFORM - INFORM
ENDSNPUT - ENDINPUT
|NPUT - INPUT
PAS CAL - PASCAL
UNK - LINK
JEXT - TEXT
96 - %
36 - %
DRBIN - DRABIN
J’ - T
5L5 - $LS
3L5 - $LS
sls - $LS
sLs - $LS
SL5 - $LS
5L3 - $LS
3L8 - $LS
3L3 - $LS